NO ./sprites/endstone.xpm
SO ./sprites/endstone.xpm
WE ./sprites/endstone.xpm
EA ./sprites/endstone.xpm


C 65,105,25
F 225,30,200








           1111111
11111111111100000111111111111111
100000000000000001000000000000011
111000000000000001000000000000001
100000000000000001000000000111111
100100000000000000000000000000001
100100000000000000000000000000001
10000000000000000000000000000000001
10000000000000000000000000000000001
10000000000000000000000000000000001
1000000000000000N000000000000000001
11111111111111111111111111111111111
