NO ./sprites/endstone.xpm
SO ./sprites/endstone.xpm
WE ./sprites/endstone.xpm
EA ./sprites/endstone.xpm


C 65,200,250
F 100,30,200



           1111111
11111111111100000011111111111111
100000000000011111110100000000011
111000000001000000000000000000001
100000000001000000000000000111111
100100000000000000000000000000001
1001000000000000N00000000000000001
10000000000000000000000000000000001
10000000000011111111000000000000001
1000000000001000000001000000000001
10000000000010000000010000000000001
11111111111111111111111111111111111