NO ./no
SO ./so
WE ./we
EA ./ea


F 220,100,0
C 225,30,0


11111111111111111111111111111111
100000000000000000000000000000011
100000000000000000000000000000001
10000000000000000000000000000111111
1001000000000000N00000000000000001


10010000000000000000000000000000001
10000000000000000000000000000000001
10000000000000000000000000000000001
10000000000000000000000000000000001
10000000000000000000000000000000001
111111111111111111111111111111111
