NO ./sprites/obsidian.xpm
SO ./sprites/quartz.xpm
WE ./sprites/endstone.xpm
EA ./sprites/emerald.xpm


C 65,200,250
F 188,152,98



111111111111111111
100000000000000011
1001010000000011111111111
100N000000000000000000001
1000000000000000011111111
100000000000000001
100000000000001111
111111111111111111