
NO ./sprites/test.xpm
SO ./sprites/test.xpm
WE ./sprites/test.xpm
EA ./sprites/test.xpm


C 255,255,255
F 255,255,255

1111111111111111111111111111111
1111111110001111110000000011111
1111111000100011000111100011111
1111100011000111111110001111111
1110000000000011100011111111111
1111111110001111000111111111111
111111110N011100000000001111111
1111111111111111111111111111111
