    F 188,152,90
C	65,200,250

NO ./sprites/obsidian.xpm
SO ./sprites/quartz.xpm
WE ./sprites/endstone.xpm
EA ./sprites/test.xpm


11111 1111111
1000111000001
1000000000001
10000000000N1
1111111111111